XSXXXXXXFXXXXX
X            X
XXXX X X XXX X
X    X  X    X
X XX XXXX XXXX
X XXX   X    X
X     X   XX X
XXXXXXXXXXXXXX
