XSXXXXXXFXXXXXXXXX
X      X     X   X
XXXX X X XXX X X X
X    X XX XX X X X
X X X  X   X X X X
X XXX XX XXX X X X
X              X X
XXXXXXXXXXXXXXXXXX
