XSXXXXXXFXXXXX
X      X     X
XXXX X X XXX X
X    X  XX   X
X XX XXXXX XXX
X XXX   X    X
X     X   XXXX
XXXXXXXXXXXXXX
