XSXXXXXXXXXXXXXX
X       X      X
XXXX X XXXXX X X
X    X  X    X X
X X XXXXX XXXX X
X XXX   X    X X
X     X   XX X X
XXXXXXXXXXXXXX X
X              X
X XXXXXXXXXXXXXX
X              X
XXXXXXXX XXXXXXX
X XXXXXX XX XX X
X X            X
F   XX X XXXXXXX
XXXXXXXXXXXXXXXX
